R 1920 1080

F 220,100,0
C 225,30,0
       1111111111111111111111111
       1000000000110000000000001
       1011000001110000000000001
       1001000000000000000000001
       1011000001110000000001111
11111111000001110111111111111
11110111111111011100000000001
11110111111111011101110010001
11000000110101011100000010001
100E0000000000001100000010001
10000000000000001100010010001
10000111010101111101110100111
11110111 1101011 110111110001
11111111 1111111 111111111111